WWWWWWWWWWWWWWWWWWWWWWWWWWWWWWWWWWW
WWWWWWWWWWWWWWWWWWWWWWWWWWWWWWWWWWW
WWTTTTTTTWWWWWWTT$TTTTTTTTTTTTTTTWW
WWTTPTTTTTTTTTTTTTTTTTFTTTTTTTTTTWW
WWTTTTTTTWWWWWWTTTTTTTTTTTTTTTTTTWW
WWTTTTTRTWWWWWWTTTTTTTTTTTTTTT$TTWW
WWWWWTWWWWWWWWWWWWWWWWWTWWWWWWWWWWW
WWWWWTWWWWWWWWWWWWWWWWWTWWWWWWWWWWW
WWWWWTWWWWWWWWWWWWWWWWWTWWWWWWWWWWW
WWWWWTWWWWWWWWWWWWWWWWWTWWWWWWWWWWW
WWWWWTWWWWWWWWWWWWWWWWWTWWWWWWWWWWW
WWWWWTWWWWWWWWWWWTTTTTTTTTTTTTTTTWW
WWWWWTWWWWWWWWWWWTTCTTTTTTTTTTTTTWW
WWWWWTWWWWWWWWWWWTTTTTTTTRTTTTTTTWW
WWWWWTWWWWWWWWWWWTTTTTTTTTTTTTTTTWW
WWTTTTTTTTTTWWWWWTTTTTTTTTTTTTTTTWW
WWTTATTTTTTTWWWWWTTTTTTTTTTTTTTTTWW
WWTTTTTTTTTTTTTTTTTTTTTTTTTTTTTTTWW
WWTTTTTTTTTTWWWWWTTTTTTTTTTTTTTTTWW
WWTTTTTTTATTWWWWWTTTTTTTTTTTTTSTTWW
WWTTTTTTTTTTWWWWWTTTTTTTTTTTTTTXTWW
WWWWWWWWWWWWWWWWWWWWWWWWWWWWWWWWWWW
WWWWWWWWWWWWWWWWWWWWWWWWWWWWWWWWWWW