    WWWWWWWWWW
    WwwwwwwwwW          WWWWWWWWWWWWWWWWW
    WwwwwwwwwW          WwwwwwwwwwwwwwwwW
    WTTTTTTTTW          WwwwwwwwwwwwwwwwW
    WTTTTTTTTW          WwwwwwwwwwwwwwwwW
    WTTTTTTTTW          WTTTTTTFFFFTTTTTW
    WTTTTTTTTW          WTTTTTTFFFFTTTTTW
WWWWWTTTTTTTTWWWWWWWWWWWWTTTTTTFFFFTTTTTWWWWWWWWWWWWWWWWWWWWWWWWW
WwwwwTTTTTTTTwwwwwwwwwwwwTTTTTTFFFFTTTTTwwwwwwwwwwwwwwwwwwwwwwwwW
WwwwwTTTTTTTTwwwwwwwwwwwwTTTTTTEEEETTTTTwwwwwwwwwwwwwwwwwwwwwwwwW
WTTTTTTTTTTTTTTTTTTTTTTTTTTTTTTEEEETTTTTTTPTTTTTTTTTTTTTTTTTTTTTW
WTTTTTTTTTTTTTTTTTTTTTTTTTTTTTTEEEETTTTTTTTTTTTTTTTTTTTTTTTTTTTTW
WTTTTTTTTTTTTTTTTTTTTTTTTTTTTTTEEEETTTTTTTTTTTTTTTTTTTTTTTTTTTTTW
WTTTTTTTTTTTTTTTTTTTTTTTTTTTTTTEEEETTTTTTTCTTTTTTTTTTTTTTTTTTTTTW
WTTTTTTTTWWWWWWWWWWWWWWWWTTTTTTeEEeTTTTTTTTTTTTTTTTTTTTTTTTTTTTTW
WTTTTTTTTW              WTTTTTTeEEeTTTTTTTTTTTTTTTTTTTTTTTTTTTTTW
WWWWWTTTTW              WTTTTTTTEETTTTTTTTTTTTTTTTTTTTTTTTTTTTTTW
    WTTTTW              WTTTTTTTEETTTTTTTTTTTTTTTTTTTTTTTTTTTTTTW
    WTTTTW              WTTTTTTTEETTTTTTTTTTTTTTTTTTTTTTTTTTTTTTW
    WTTTTW              WTTTTTTTEETTTTTTTTTTTTTTTTTTTTTTTTTTTTTTW
    WTTTTW              WTTTTTTTEETTTTTTTTTTTTTTTTTTTTTTTTTTTTTTW
    WTTTTW              WTTTTTTTEETTTTTTTTTTTTTTTTTTTTTTTTTTTTTTW
    WTTTTW              WTTTTTTTEETTTTTTTTTTTTTTTTTTTTTTTTTTTTTTW
WWWWWTTTTW              WTTTTTTTEETTTTTTTTTTTTTTTTTTTTTTTTTTTTTTW
WTTTTTTTTW              WTTTTTTTEETTTTTTTTTTTTTTTTTTTTTTTTTTTTTTW
WTTTTTTTTW              WTTTTTTTEETTTTTTTTTTTTTTTTTTTTTTTTTTTTTTW
WTTTTTTTTW              WTTTTTTTEETTTTTTTTTTTTTTTTTTTTTTTTTTTTTTW
WTTTTTTTTW              WTTTTTTTEETTTTTTTTTTTTTTTTTTTTTTTTTTTTTTW
WTTTTTTTTW              WTTTTTTTEETTTTTTTTTTTTTTTTTTTTTTTTTTTTTTW
WTTTTTTTTW              WTTTTTTTEETTTTTTTTTTTTTTTTTTTTTTTTTTTTTTW
WTTTTTTTTW              WTTTTTTTEETTTTTTWWWWWWWWWWWWTTTTTTTTTTTTW
WTTTTTTTTW              WTTTTTTTEETTTTTTW          WTTTTTTTTTTTTW
WTTTTTTTTW              WTTTTTTTEETTTTTTW          WTTTTTTTTTTTTW
WTTTTTTTTW              WTTTTTTTEETTTTTTW          WTTTTTTTTTTTTW
WTTTTTTTTWWWWWWWWWWWWWWWWTTTTTTTEETTTTTTW          WTTTTTTTTTTTTW
WTTTTTTTTWwwwwwwwwwwwwwwwTTTTTTTEETTTTTTW          WTTTTTTTTTTTTW
WTTTTTTTTWwwwwwwwwwwwwwwwTTTTTTTEETTTTTTW          WTTTTTTTTTTTTW
WTTTTTTTTWTTTTTTTTTTTTTTTTTTTTTTEETTTTTTW          WTTTTTTTTTTTTW
WTTTTTTTTWTTTTTTTTTTTTTTTTTTTTTTEETTTTTTW          WTTTTTTTTTTTTW
WTTTTwwwwwTTTTTTTTTTTTTTTTTTTTTTEETTTTTTW          WTTTTTTTTTTTTW
WTTTTwwwwwTTTTTTTTTTTTTTTTTTTTTTEETTTTTTW          WTTTTTTTTTTTTW
WTTTTwwwwwTTTTTTTTTTTTTTTTTTTTTTEETTTTTTW          WTTTTTTTTTTTTW
WTTTTTTTTTTTTTTTTTTWWWWTTTTTTTTTEETTTTTTW          WTTTTTTTTTTTTW
WTTTTTTTTTTTTTGGGTTW   WTTTTTTTTEETTTTTTW     WWWWWWTTTTTTTTTTTTW
WTTTTTTTTTTTTTGGGTTW    WTTTTTTTEETTTTTTW     wwwwwwTTTTTTTTTTTTW
WTTTTTTTTTTTTTTTTTTW     WTTTTTTEETTTTTTW     wwwwwwTTTTTTTTTTTTW
WTTTTGGGGGGGGGGGGTTW     WTTTTTTEETTTTTTWWWWWWWTTTTTTTTTTTTTTTTTW
WTTTTGGGGGGGGGGGGTTW     WTTTTTTEETTTTTTTTTTTTTTTTTTTTTTTTTTTTTTW
WTTTTTTTTTTTTTTTTTTW     WTTTTTTEETTTTTTTTTTTTTTTTTTTTTTTTTTTTTTW
WTTTTTTTTTTTTTTTTTTW     WTTTTTTEETTTTTTTTTTTTTTTwwwwwwwwwwwwwwwW
WTTTTTTTTTTTTTTTTTTW     WTTTTTTEETTTTTTTTTTTTTTTWWWWWWWWWWWWWWWW
WWWWWWWWWWWWWWWWWWWW     WTTTTTTEETTTTTTTTTTTTwwwW
                         WTTTTTTEETTTTTTTTTTwwWWWW
                         WTTTTTTEETTTTTTTTwwWWWWWW
                         WTTTTTTEETTTTTTwwWWWWWWWW
                         WTTTTTTEETTTTTTWWWWWWWWWW
                         WTTTTTTEETTTTTTWWWWWWWWWW
                         WTTTTTTEETTTTTTW
                         WTTTTTTEETTTTTTW
                         WTTTTTTEETTTTTTW
                         WTTTTTTEETTTTTTW
                         WTTTTTTEETTTTTTW
                         WTTTTTTEETTTTTTW
                         WTTTTTTEETTTTTTW
                         WTTTTTTEETTTTTTW
                         WTTTTTTEETTTTTTW
                         WTTTTTTEETTTTTTW
                         WTTTTTTEETTTTTTW
                         WWWWWWWWWWWWWWWW